111111111
100E001
10P0C00
111111111