111111111
10000E001
1P000C701
111111111