111111111
10000E001
1P000C001
111111111