111111111111111111111111111111111111111111111111111
1P0000000000000100010000000001000001000000000000001
101111111111110101111111111101011101011111110111111
100010100000100100000010000101000101000101010001001
111010110111101111100100110101111101010001010100011
10001C000010100100001001000100000001011111111111111
101110101000110111110011011111111101000000000000001
100010101010000000000111000000000101111111111111111
111010111111111111111111111111110100000000000000001
1C0010000000100100000000C00000000101111111111111101
101111111110110101101111111111111101011111111111101
10000000M000000100101000000000000001000000000000001
111111111111111111101111111111011011111111111111111
1010001M0000000000000000000001001000000000000000001
101010101111111111111111111101011011111111111111101
1010101010000000001000000000C1000100000000000000001
101010101011111111101111111111110111111111111111101
101010101000000000100000000000E10000000000000000101
101010101111111110111111111111111111111111101111101
100010001000000000000100010001001000100001000101001
111111111111111111111101000100010010001000000000101
100000000000000000000101111111111111111111111110101
110111111011111110110100000000000000000000000000101
100100010001000100010111111111111111111111111111101
110001000100010001010000000000000000000000000000001
111111111111111111111111111111111111111111111111111