11111111
10C000P1
100E0001
10000001
10000001
10000001
10000001
1CC11CC1
11111111
