11111111111111
1P0000000000E1
11100000000001
1C001111100011
11100000000101
10001C10000011
11111111111111