11111111
100000P1
100E0001
11111111